wwwwwwwwwwwwwwwwwwww
w                  w
w                  w
w                  w
w     b            w
w                  w
w                  w
w                  w
w                  w
w                  w
w                  w
w        c         w
w                  w
w                  w
w                  w
w                  w
w                  w
w                  w
w                  w
wwwwwwwwwwwwwwwwwwww